CCCCCCCC
CCCCCCCC
CA.CXXXC
C..BB..C
C.B...CC
C..CCCCC
C..CCCCC
CCCCCCCC
