CCCCCCCC
CCCCXXXC
CC..BA.C
CC..B.CC
CC..CCCC
CC.BB.XC
CC.....C
CCCCCCCC
