..CC....
XXB..C..
XX..CC..
CCC..CB.
CAB..B..
........
.CCCCCCC
........
