CCCCCCCC
CCCCCCCC
C...CA.C
C....B.C
C...C..C
CCCCCBXC
CCCCC.XC
CCCCCCCC
