.CCCCCCC
..CCCCCC
.BCCXCCC
.....CCC
.AXB.CCC
XCB.CCCC
CC..CCCC
CCCCCCCC
