CCCCCCCC
C..CCCCC
C.BC..CC
CX...BCC
C...C.CC
..CBCXCC
.CC.CCCC
A...XCCC
