CCCCCCCC
CCCCCCCC
CCCCCCCC
CXA.C..C
C..BBB.C
CXX....C
CCCCCCCC
CCCCCCCC
