CCCCCCCC
CC.....C
CC.B...C
CC..C..C
CC.CCCCC
CAB...CC
CX.X..CC
CCCCCCCC
