CCCCCCCC
CCCC...C
CCAB.C.C
CCBB...C
C..CC.CC
CX.X...C
CC...X.C
CCCCCCCC
