.......X
........
........
...B....
...B....
........
..CCCCCC
A......X
