.......X
........
........
...B....
C.BB....
....C...
..CCCCCC
A.....XX
