CCCCCCCC
CC..CCCC
CCB.CCCC
CC..XCCC
...B.CCC
..A.B.CC
.C..X.CC
XCCCCCCC
